82486114 lihuang xuli02290894@sina.com	 

Adler David H. dha@panix.com	 paid 

akinboyowa ayodeji eminikan1@hotmail.com	

Alexander Ken dma_pres@yahoo.com	 paid

Allen Daniel da@coder.com	 paid

Ames Bryan ba7916@sbc.com	 paid

Anderson Bill banderson@ded.state.mo.us	 

Andreychek Eric eric@openthought.net	 paid

Andreychek Shana eric@openthought.net	 paid

APPOH JUSTICE PRINCE justprincegh@yahoo.com	 

Ashton Elaine elaine@chaos.wustl.edu	 paid

Auld Warren warren@ded.state.mo.us	 

Awoyemi Adeola adeola@alphatwo.net	 paid

Bair Heath bairh@yahoo.com	 paid

Baisden Damon dbaisden@watson.wustl.edu	  

Barcomb Ann ann@domaintje.com	  paid

BATKO Alex abatko@cs.mcgill.ca	  paid

Bear Matthew T mtbear@mpowercom.com	  

Bedell Joseph jbedell@oriongenomics.com	  paid

Benedetto Bill bbenedetto@goodyear.com	  paid

Berkowicz Nicolas nberkowi@watson.wustl.edu	  

Blackstone J. David jdavidb@goreadthebible.com	  paid

Blasiar Darin dblasiar@watson.wustl.edu	  

Boal Paul pboal@apo49.org	  paid

Bodoni John jbodoni@hotmail.com	  paid

Boggs Gene gene@ology.net	  paid

Boroughf Holmes Boroughf.HF@acm.org	  paid

Boschert Joshua jambe@cpan.org	  paid

Boumans Jos kane@cpan.org	  

Bowen Rich rbowen@rcbowen.com	  paid

Brooks Chris cbrooks@carescout.com	paid  

Brown Alonzo alonzo_brown@mastercard.com	paid  

Burcham Sarah sarah@pound.perl.org	  paid

Bushee Glenn glenn@easy-access.com	  paid

Byrd Nathaniel nathan_byrd@mastercard.com	  paid

Caine Todd tcaine@eli.net	  paid

Carter James jcarter9@fuse.net	  paid

Chinwalla Asif achinwal@watson.wustl.edu	  

Citek Robert rwcitek@alum.calberkeley.org	  paid

Cobbs	Cathy A.	cathyc@iquest.net	paid

Corder Ryan ryanc@silverorb.net	  paid

Cordes Kyle kyle@kylecordes.com	  paid

Corzine Deven deven@ties.org	  paid

Cozens Simon simon@netthink.co.uk	  paid

Cramer Michael cramer@webkist.com	  paid

Crawford David dc@omor.com	   paid

Crouse Kevin kcrouse@watson.wustl.edu	 paid  

Crow Phil philcrow2000@yahoo.com	   paid

Dahms Karsten KDIB@AOL.COM	   paid

Deeds Dallas deedsd@nationwide.com	   paid

Dice Richard rdice@pobox.com	   paid

Doherty Josh jad5730@bjc.org	   paid

Dominus Mark mjd-yapc+@plover.com	   paid

Donnelly James tripp@bgtelecommunications.com	  

Dooling David ddooling@watson.wustl.edu	   paid

Drendel Mandy mandy@polybayes.wustl.edu	  

Drew Bradley bradnone@hotmail.com	   paid

Ducy	Michael	michael@michaelandniki.com	 paid

Eason	Jane paid

Eason	Thomas paid

Edney	William paid

edward anyetei nai-sowah eddiesnipes@yahoo.com	  

El khoury Rony rek@fti-ibis.com	  paid

Eldred James jeldred@watson.wustl.edu	  

Ellis Don donls@sluug.org	  paid

Engbert Fran fpe3319@bjc.org	  paid

Erb Thomas terb@watson.wustl.edu	  

Erle Schuyler schuyler@oreilly.com	  paid

Eye Kevin eye@buffalo.edu	  paid

Falcone Kevin kevin@jibsheet.com	paid  

Faqir Tahir tahir_faqir@mastercard.com	  paid

Ferrency Alan yapc@alan.ferrency.com	  paid

Fewell Ginger gfewell@watson.wustl.edu	  paid

Floyd	Brandon	paid

Foulke Andrew engdy@engdy.net	  paid

Fragassi Michael frag@enteract.com	  

Francis Scott darkuncle@darkuncle.net	  paid

Fung Angus caf100@email.mot.com	  paid

Furnival Lawrence lrf10@columbia.edu	  paid

Gallaway Geoffrey geoffeg-yapc@geoffeg.org	  paid

Gibbs Tanton thgibbs@deltafarms.com	  paid

Goff Jeffrey drforr@hargray.com	  paid

Goldenbaum Todd todd@marigoldtech.com	  paid

Gottipatti	Giridhar	paid

Goulet Walter walter.goulet@motorola.com	  paid

Graves Kenneth kag@citysource.com	  paid

Gray Jamin jamin@pubcrawler.org	  paid

Gray Bruce bruce.gray@acm.org	  paid

Guttman Uri paid

Hann Brian brian.hann@umb.com	  paid

Hawley Patrick phawley@ociweb.com	paid  

Hernandez Isabelle ih92@columbia.edu	  paid

Hershberger Mark mah@everybody.org	  

Hickman Justin jhickman@mpowercom.com	  

Hixson Lawrence K. aquacade@aquacade.net	  paid

Hockenhull Ben benh@jpj.net	  paid

Howell Stephen paid

Hubbard Jerry jhubbard@mlc.net	  paid

Huddleston Kevin kjh28@cornell.edu	  paid

Hudes Dana dhudes@hudes.org	  paid

Hulsey James hulsey1@mindspring.com	  

Jewell Curtis curtis@curtisjewell.com	  

Johston Joe jjohn@cs.umb.edu	  paid

Kamkar Samy SKamkar@LucidX.com	  paid

Kanafene Anton akanafene@yahoo.com	  paid

Keddie Diane dkeddie@buffalo.edu	  paid

Keenan James jkeen@concentric.net	  paid

Kenner Jacob jacob+yapc@causative.net	  

Keroes Joshua jkeroes@eli.net	  paid

Kidder Eric eric.j.kidder@ameritech.com	  paid

King Michael mike808@users.sourceforge.net	  paid

King Brian bbking@checkfree.com	  paid

Kline Joe jkline@one.net	  paid

Kloss John jkloss@sapiens.wustl.edu	  

Kowalski Dennis dennis.kowalski@ncr.com	  paid

LaBrier Paul pmlabrier	  paid

Lammert Leland lvl@omnitec.net	  

Lawson Michael Michael_Lawson@mastercard.com	  paid

Leather Sean paid

Leffert Doug doug@ded.state.mo.us	  

Lenzo Kevin lenzo@yapc.org	  paid

Leong Shin sleong@watson.wustl.edu	  paid

Lester Andy andy@petdance.com	  paid

Lim Kahn-Yih paid

Lloyd David dlloyd@sgi.com	  paid

Loliger Donna dloliger@buffalo.edu	  paid

Long Justin justin.long@acs-inc.com	  paid

Lonstein Ross rlonstein@pobox.com	  paid

Lopresto Adam adam@cec.wustl.edu	  paid

Mabe David dmabe@att.com	  paid

Maciag Glenn glenn_maciag@kaplan.com	paid  

Mankowski Walt waltman@pobox.com	  paid

Marbach Randall remarbach@yahoo.com	  paid

Marbach Chris remarbach@yahoo.com	  paid

Martin John jmartin@watson.wustl.edu	  paid

McClellan Tad tadmc@augustmail.com	  paid

McMahon Joe mcmahon@ibiblio.org	  paid

McNabb Steve steve@justsomeguy.com	paid  

Meyers Scott scott@mydogateit.com	  paid

Michalski Brent brent_michalski@mastercard.com	  paid

Michaud Patrick pmichaud@pobox.com	  paid

Milford Casey casey.milford@conwaycorp.net	  paid

Millard Paul paul.millard@umb.com	  paid

Mison Paul paulm@husk.org	  paid

Moree Jeremiah (JT) moreejt@xperienceinc.com	  

Motabar Iraj irajm@erlangtech.com	  paid

Murray Craig cmurray@purina.com	  paid

Nandor Chris yapc@pudge.net	  paid

Neches Russell russell@ccs.neu.edu	  paid

Neely Nate nate@works.state.mo.us	  

Nelson Joanne jnelson@watson.wustl.edu	  

Nesting David david+yapc@fastolfe.net	  paid

Nyman Lisa delegatrix@yahoo.com	  

Oberkfell Ben boberkfe@watson.wustl.edu	  

Odom Bill wnodom@intrasection.com	  paid

odunayo michael smallword@onebox.com	  

Oesterly Jason oesterly@yahoo.com	  paid

Olson Todd tco2@cornell.edu	  paid

Orwant Jon jon@orwant.com	  paid

Ostrowski Dan paid

Ozersky Philip pozersky@watson.wustl.edu	  

Palmer Paul ppalmer@spectrum.carenet.org	  paid

Palmer Luke fibonaci@babylonia.flatirons.org	  paid

Parker Jim parkerjr@ix.netcom.com	  paid

Patrick Darian dapatrick@danthony.net	  paid

Pattie James james@pcxperience.com	  

Pearcey Dieter hdp@pobox.com	  paid

Phoenix Tom rootbeer@redcat.com	  paid

Pierce Clinton clintp@geeksalad.org	  paid

Pinkard Dan dan@lotn.org	  paid

Pohl Craig cpohl@watson.wustl.edu	  paid

Porter Jason jporter@seistl.com	  paid

Powers Shelley shelleyp@burningbird.net	  paid

Pritchard Steven steve@silug.org	  paid

Przybylski John johnp9@bellatlantic.net	  paid

Purdum Katie kathryn.purdum@samspublishing.com	  paid

Putney Susan putney@buffalo.edu	  paid

Quinlan Sean sean@quinlan.org	  paid

Quote Mr kurt@thepope.rog	  paid

Rabinowitz Josh joshr-yapc@joshr.com	  paid

Randal Allison al@shadowed.net	  paid

Randolph James jrandolp@watson.wustl.edu	  

Reinhardt Chris ctriv@dyndns.org	  paid

Reitz Randolph rreitz@fnal.gov	  paid

Rice Jim rice@kids.wustl.edu	  paid

Rietz Ken krietz@krietz.org	  paid

Rodriguez Michel mirod@xmltwig.com	paid  

Rogers Bill brr9684@bjc.org	  paid

Roof Rex yapc@rexroof.com	  paid

Schertler Roderick roderick@argon.org	  paid

Schout Michael mschout@gkg.net	  paid

Schultz Brian bschultz@watson.wustl.edu	  paid

Seigworth Michael mikeseig@yahoo.com	  paid

Semanek Marcus msemanek@yahoo.com	  paid

Sharp Ben ben_sharp@mastercard.com	  paid

Sharp John john.sharp@tfriend.com	  paid

Shepard Larry larry.shepard@gbe.com	  

silvey matthew duncan@thorn.net	  paid

Sinclair Eliot es7@cec.wustl.edu	  paid

Singh Indy indy@indigostar.com	  paid

Sinha Prashant psinha@watson.wustl.edu	  

Sitney Blake  blake@inch.com	  paid

Smith Scott ssmith@watson.wustl.edu	  paid

Song Haoyu 

Spier Robert rspier@pobox.com	  paid

Sproull Todd paid

St-Louis Luc lucst@sympatico.ca	  paid

Steinert Jonathan hachi@kuiki.net	  paid

Steward Ronald gloknoid@famvid.com	  paid

Stok Michael mike@stok.co.uk	  paid

Tam Jeff paid

Taylor Drew dtaylor@carescout.com	  paid

Tessier Mark paid

Thaxton Carter cartert@erlangtech.com	  paid

Threet Robert rthreet@usi.edu	  paid

Till Jeffrey jatill@buffalo.edu	  paid

Tohlen James james.tohlen@eds.com	  paid

Torkington Nathan gnat@oreilly.com	  paid

trader paul fliptop@peacecomputers.com	  paid

Trevino Juan TrevinoJ@gao.gov	  paid

Tucker Alan alan@alanvtucker.com	  

Turner David novalis@novalis.org	  paid

Ulevitch David davidu@everydns.net	  paid

Underwood Peter peter.underwood@libertymutual.com	  paid

Urhahn John webdesign@litw.org	  paid

vasanthakumar geetha paid

Vaughn Chris cvaughn@purina.com	  paid

Veit Stephen sveit@earthlink.net	  paid

Vette Brian bv3296@sbc.com	  paid

Vieux Ellen evieux@polybayes.wustl.edu	  

Vincent Jesse jesse@bestpractical.com	  paid

Wallis John jwallis@watson.wustl.edu	  paid

Wayne Shiping paid

Warnock Bryan bwarnock@capita.com	  paid

Watkiss Neil NeilW@ActiveState.com	  paid

Wegmann Paul wegmann_p@kids.wustl.edu	  paid

Wendl Mike mwendl@watson.wustl.edu	  paid

West Casey cwest@aaronsen.com	  paid

wickline matthew m_yapc2002_reg@wickline.org	  paid

Widmer Rad rwidmer2@mindspring.com	  paid

Wilde Timothy twilde@dyndns.org	  paid

Wong Anthony a-wong2@northwestern.edu	  

Wong Meng mengwong@pobox.com	  paid

Wylie Todd twylie@watson.wustl.edu	  paid

Yang Shiaw-Pyng syang@wwatson.wuslt.edu	  paid

Young Geoffrey geoff@modperlcookbook.org	  paid

Young David dcyoung@pobox.com	  paid

Zacks Evan e@zacks.org	  paid

